11111111111111111111111111111111111111111111111111111
1E0000000000000C00000C0000111111110000000001000000001
10100101001000001010010000000100000000100000C00110011
10100100101010100010010111000000000011010110000101101
10100101001000001010010000000101000000101100000000001
10100100101010100010010000011110010010100000000000011
1010010100100C001010010000000000000001010001000000001
10100100101010100010010000000101000000000011111111011
10100101001000001010111111101000000010100000000000011
101001001010101000100100000001010000H0000000000001001
1010010100100000101001000000010100000000C000000000011
100000H00000000001100V0000001111100000000000000000001
10100111111001010101000100100000001010000000000100001
10100101001000001010000000001000010100001110100010001
10100100101010100010010000011110010010100000000000011
10100101001000001010010000000000000001010001000000001
10100100101010100010010000000101000000000011111111011
10100101001000001010111111101000000010100000000000011
10100100101010100010010000000101000000000000000001001
1010010100100000101001000000010100000000C000000000011
1000000000000C0001100C00000011111000000000C0000000001
10100111111001010101000100100000001010000000000100001
101001010010000010100H0000001000010100001110100010001
10100100101010100010010000000000000010100010000000001
10100101001000001010010011111110000000100000000100001
10100100101111110101000100001000000010100000000000011
1C10010100100000100000000100100C000010100000111000001
10100100101010111101010001001000000010100100100000001
101001010111110100000101001000000010100000000000H1C01
10100100101010100010010000000101000010000000000000001
100000000C00C00000V00000000000000010000000VC00P101001
11111111111111111111111111111111111111111111111111111

