


111111111111111111111111111111
1E00000000000C00000C0000000001
101001010100001010010V00001001
101001000101010010010000010101
1P00000C00C00000000000000000C1
10100100101010V001001001000011
100000101000001111000000001C01
101001010010001010010H00001101
100000C000V00000000000000010C1
111111111111111111111111111111

