


111111111111111111111111111111111111111111111
1E0000000000000C00000C00000000000000000000001
101001010010000010100100000001000000001000011
101001001010101000100100000000000000000101101
101001010010000010100100000001010000001000001
101001001010101000100100000001010000000000011
101001010010000010100100000001010001000000001
101001001010101000100100000001010000000000011
101001010010000010100100000001010000000000011
101001001010101000100100000001010000000001001
101001010010000010100100000001010000000000011
100000000000000000000000000000000000000000001
101001001010101000100100000001010000000100001
101001010010000010100100000001010000000010001
101001001010101000100100000001010001000000001
101001010010000010100100000001010000000100001
101001001010101000100100000001010000000000011
101001010010000010100100000001010000111000001
101001001010101000100100000001010000100000001
101001010010000010100100000001010000000001001
101001001010101000100100000001010000100000001
1P0000000C00C000000000000000000000100000000C1
111111111111111111111111111111111111111111111
