


111111111111111111111111
1E00000000C000C000000001
101001010010000010010101
101001001010010010010101
10000000C00C000P000000C1
111111111111111111111111