


1111111111111111111111111111111
1E00000000000C00000C00000000001
101001010100001010010V000001001
1010010001010100100100000100101
1P00000C00C000000000000000000C1
10100100101010V0010010010000011
1000001010000011110000000001C01
101001010010001010010H000001101
100000C000V000000000000000010C1
1111111111111111111111111111111

